0,0,0,3175,0,2762,3276,0,4485,2977,3030,0,0,3949,2865,0,0,3000,0,0,1991
3313,0,1318,0,1294,0,0,803,0,0,1490,1305,645,0,521,1014,0,0,0,0,0
0,0,0,204,583,206,966,677,0,0,0,2084,690,0,1011,925,0,285,1511,0,0
0,0,204,0,460,409,1136,747,0,714,330,2052,739,1550,1059,1077,0,280,0,0,1381
3339,0,583,0,0,0,0,0,0,0,731,0,0,1347,1101,1209,0,0,1794,0,1588
0,1498,0,409,785,0,0,0,2436,0,0,2290,714,1764,1035,0,0,0,1497,1403,0
0,0,0,1136,1545,0,0,1418,0,0,0,0,1458,2498,1778,0,1104,1176,0,650,0
0,0,677,747,0,0,1418,0,1975,0,895,0,0,0,0,328,0,513,0,2068,0
0,1172,0,2224,0,0,3196,1975,0,2897,2428,676,1817,698,0,2185,2565,0,0,0,2974
2977,2018,0,0,1115,460,0,1118,2897,0,0,0,1159,2198,0,0,805,0,0,0,0
0,0,172,0,731,269,269,895,2428,550,0,2280,0,0,1183,0,0,457,1683,1500,0
4532,0,0,0,0,2290,2971,1936,0,0,0,0,1178,668,0,0,2507,1799,0,3231,2937
0,0,690,0,0,0,1458,158,0,0,0,1178,0,0,0,328,724,0,0,2108,0
0,636,0,1550,1347,0,2498,1439,698,2198,0,668,0,0,1157,0,2010,0,2097,3188,0
2865,521,0,0,1101,1035,1778,425,0,0,0,1762,0,1157,0,618,0,0,1011,2428,0
0,1014,925,0,1209,0,0,0,0,0,0,0,0,1724,618,0,0,0,586,2187,898
0,1365,0,0,1160,583,1104,0,0,0,0,2507,0,0,1109,331,0,0,946,0,428
0,1033,285,0,0,0,0,513,1971,0,457,0,471,1273,792,0,821,0,1476,1827,1249
0,1460,0,1662,1794,1497,0,0,2631,0,0,0,1048,2097,0,0,0,0,0,2707,0
3927,2868,0,0,0,1403,650,0,3886,949,1500,0,0,0,2428,2187,0,0,2707,0,0
0,0,0,1381,1588,0,1455,1019,0,0,1205,2937,1157,2409,0,0,428,0,0,2105,0
