0,0,0,3175,3339,2762,0,2610,4485,0,3030,4532,2753,0,2865,0,0,3000,0,3927,1991
3313,0,1318,1326,1294,1498,2218,803,0,2018,1490,0,645,0,521,1014,1365,1033,1460,2868,0
2963,1318,0,204,0,0,0,677,2256,0,0,2084,690,1558,1011,0,747,285,0,0,1175
3175,0,204,0,0,409,1136,747,0,0,330,2052,0,1550,1059,1077,0,280,1662,1786,0
0,1294,0,0,0,0,1545,0,2047,0,0,1827,0,1347,0,1209,1160,340,0,2196,0
0,0,0,0,785,0,0,1662,2436,0,269,2290,714,1764,1035,911,583,0,0,1403,937
0,0,966,0,1545,760,0,0,3196,460,269,0,1458,2498,1778,1537,1104,1176,0,0,0
0,803,677,0,0,0,1418,0,0,1118,0,0,0,0,425,328,0,513,0,2068,0
4485,1172,2256,2224,2047,0,3196,1975,0,2897,2428,0,0,0,1693,2185,2565,1971,2631,3886,0
2977,2018,597,714,0,460,460,1118,2897,0,0,2671,0,2198,1479,0,0,0,1751,949,1155
0,1490,0,0,0,269,269,0,2428,0,0,2280,0,1730,1183,0,0,457,0,0,0
0,1305,0,2052,1827,0,2971,0,676,0,2280,0,1178,668,0,0,2507,1799,2700,0,2937
0,0,0,739,0,714,1458,158,1817,0,0,0,0,1281,320,328,724,471,0,0,0
0,0,0,0,1347,0,2498,0,0,2198,0,0,0,0,0,0,0,1273,0,0,2409
0,521,0,0,0,0,0,0,0,0,0,0,320,1157,0,0,0,0,0,2428,0
0,1014,0,0,1209,911,0,0,0,0,1098,0,0,0,618,0,0,856,0,0,898
2179,0,0,0,0,0,0,0,2565,805,0,2507,0,2010,1109,0,0,821,0,0,428
3000,0,0,0,340,0,0,0,1971,0,0,0,471,0,792,856,0,0,1476,0,1249
0,0,1511,1662,0,0,0,0,0,1751,0,0,0,2097,1011,586,0,1476,0,2707,0
3927,2868,0,0,0,0,0,0,0,949,1500,0,2108,3188,0,0,0,0,2707,0,0
1991,1802,0,0,1588,0,0,0,2974,0,1205,0,1157,2409,0,898,0,1249,0,0,0
