0,3313,0,0,0,0,0,0,0,0,3030,0,0,0,0,0,2179,3000,0,0,1991
0,0,0,1326,1294,0,0,0,1172,0,1490,1305,645,0,0,0,0,1033,1460,2868,0
0,1318,0,0,0,206,966,0,0,0,172,0,690,0,1011,0,0,0,1511,1616,0
0,0,204,0,460,0,1136,0,0,0,0,0,0,0,0,1077,0,0,1662,0,1381
0,0,583,0,0,785,0,0,2047,1115,0,1827,789,1347,1101,1209,0,340,0,0,0
0,1498,0,0,0,0,760,0,2436,460,269,2290,0,0,1035,911,0,465,0,1403,0
0,0,966,0,0,760,0,0,0,460,269,2971,0,2498,1778,1537,1104,0,0,0,0
0,0,0,0,853,0,0,0,0,0,0,0,158,0,0,0,0,0,995,0,1019
0,1172,0,2224,0,2436,3196,1975,0,2897,2428,0,0,698,0,0,2565,0,0,0,0
2977,0,597,0,1115,0,0,0,2897,0,0,0,1159,0,1479,0,805,0,0,0,1155
3030,0,0,0,731,0,269,0,0,0,0,0,0,0,1183,1098,0,457,1683,0,0
4532,0,0,2052,1827,2290,0,0,0,0,0,0,1178,0,0,0,0,1799,0,0,2937
2753,645,0,0,0,0,1458,0,1817,1159,0,1178,0,1281,320,0,0,0,0,2108,0
0,636,1558,0,0,0,2498,0,698,2198,1730,0,0,0,1157,1724,0,0,0,3188,0
2865,0,1011,1059,0,1035,0,425,1693,1479,0,0,320,1157,0,0,1109,792,0,0,1363
2282,0,0,1077,1209,911,0,328,0,1238,0,0,0,1724,618,0,0,0,0,0,0
0,1365,747,0,1160,0,1104,0,2565,805,0,0,724,0,0,331,0,0,0,0,0
0,0,0,0,0,465,1176,0,0,877,457,1799,0,0,0,0,0,0,0,1827,0
0,0,0,0,0,1497,0,995,0,1751,0,0,1048,2097,1011,586,0,0,0,0,1209
3927,0,0,1786,0,0,650,0,0,0,1500,0,0,3188,2428,0,1754,1827,0,0,0
1991,0,0,1381,0,0,0,0,0,1155,1205,0,1157,0,0,0,428,0,0,2105,0
