969,0,4170,7317,1383,7457,3789,9354,8293,1222,5622,8860,9179,7830,4504,4238
6889,0,3081,2004,8949,9002,8808,6532,0,8587,8751,4264,435,1299,2986,7965
7700,6042,3398,8265,689,0,2687,7717,1300,2299,0,1596,9567,3396,2654,1455
6441,7635,1850,3502,5746,2824,4538,326,5542,9827,5987,1538,8968,3342,3595,5461
9074,5938,0,5899,7194,507,6181,682,4313,9744,2299,6137,4998,4371,8582,4974
5593,2087,776,2977,304,286,4933,3929,3253,3197,0,7766,8235,9687,3551,5234
4431,3370,4083,6049,813,2354,28,3706,5631,7964,5298,1573,7065,3494,6363,2844
0,24,1533,5436,5041,4449,9401,2570,0,0,4906,8242,4395,7139,4488,0
2340,783,0,799,0,9958,0,4068,5779,0,3651,1739,3882,1639,7961,6710
2859,2568,5497,3490,9391,912,2602,9696,0,3799,0,6214,1917,6565,2655,4698
6169,9652,9600,4555,0,3549,9629,929,5438,2592,2573,0,6103,6124,5966,0
0,1813,1154,9367,1811,5173,6889,2926,5861,169,5212,7541,5921,917,0,5808
7485,8622,2393,1567,3610,5059,5039,6278,4069,3361,836,9163,0,3052,8649,6642
3917,8940,573,1388,4769,4233,4263,8054,3923,3172,0,4419,6167,4744,4549,7029
2398,8146,7795,6012,0,3342,7756,7007,3205,6000,2342,3039,4243,3052,4347,366
0,6003,1342,9743,8250,331,9195,3542,6941,6586,1831,2434,3946,8653,4371,1681
