0,2719,7071,8151,220,5260,4353,154,7078,7153,1980,3102,6555,307,3265,3679
557,4503,6816,3385,8219,224,2415,4791,0,3274,3631,667,8420,5778,4864,554
8271,981,29,1102,1802,6703,0,1675,5770,1984,41,0,596,0,0,3081
2226,5398,9453,2973,9339,8489,6450,3375,2140,0,8179,8724,3725,370,861,9584
9490,8121,2774,3031,5036,4704,8604,4417,1926,0,2130,9533,2318,9322,4550,4818
3925,668,4190,3620,3245,271,615,1342,5798,5600,3903,0,9275,7975,8622,0
3645,7675,5452,0,4929,9241,3623,2508,2098,1506,2920,5309,7566,8754,2224,2984
2598,532,69,921,2244,5936,3596,7720,4704,5679,968,8263,0,0,3205,9739
893,5088,1374,8933,0,4263,7379,3263,8694,7086,4968,1115,0,1244,0,1495
3382,8406,6130,0,6941,5817,0,8780,5687,0,1094,872,2097,8587,4143,8899
1057,2884,0,781,7201,3799,2103,0,607,8009,617,506,5638,9089,3137,7076
863,737,1271,9360,220,9013,2959,1887,7771,5450,6867,8070,7537,9924,0,5609
884,2163,6636,2032,8420,0,6790,3399,8064,8290,4783,0,7432,0,1900,4421
9534,4545,1747,6565,3363,3570,6126,600,5638,1071,1856,1658,7622,0,1165,5612
1851,8216,2526,3164,1383,9014,7168,3060,8160,8408,3420,1330,715,9069,8903,3817
514,839,5150,789,240,1175,1954,4504,1578,2888,8332,6253,2303,5624,1466,9959
