4514,1173,1968,9739,513,5169,3983,7452,3164,9213,9795,8346,3545,6350,1989,4786,0,8330,9386,2186,1509,8400,7211,1934,1930,4918,0,2618,8681,7070,2770,6899
5347,7836,636,9073,8385,3645,2528,2156,809,2814,4916,8881,7314,4955,880,698,274,9518,8092,2335,7242,1386,1184,1951,530,7384,39,7761,98,3891,7154,1321
9779,7739,2993,0,422,7882,649,293,0,5185,0,0,4057,8016,4837,8485,8027,0,0,8003,1451,0,2922,12,7644,1391,2023,6059,2387,1153,1015,755
8604,8142,3153,2781,644,8126,581,0,8864,4117,7492,3457,9732,5468,7450,6811,0,9152,5597,0,5781,9813,1141,1802,38,5377,1369,1121,3794,9022,938,0
8626,3300,3387,7583,4672,3827,6936,0,3468,5605,0,8522,3524,0,6966,7419,2201,7915,0,7024,1360,4039,8143,8080,9239,875,0,7226,9111,5413,6507,5872
0,4484,1966,763,1597,408,2446,2132,1570,9384,9185,1390,5687,151,0,3794,0,8820,5247,929,4896,7979,0,5501,7203,8141,637,9558,7591,6071,0,2196
508,3211,2705,0,1051,6679,3399,1822,9016,2725,1164,0,1001,2218,0,5495,7162,4036,6284,344,2683,3995,2384,4670,4709,0,7033,3866,4597,5040,6129,6936
1017,8153,3,9943,7170,4453,4144,8344,993,3296,9706,8763,8927,2001,6691,5615,5028,0,4463,8389,1179,8880,9858,3543,7670,0,2857,2158,1647,5111,4067,2037
0,2962,4271,5007,2012,0,1560,9397,4763,4443,2436,5762,9397,9739,8928,5033,4709,0,5952,7874,8749,1124,0,5117,3590,8859,4650,9869,7883,1616,0,7861
9967,0,2336,5883,5806,4060,5669,3658,9271,9727,0,3325,4973,4525,3441,4757,1601,664,9653,3523,6110,1924,6939,8843,0,9069,7908,7405,6234,2943,0,844
0,5142,4706,6767,2320,3814,5015,2671,242,0,8795,1726,9348,1679,7002,4356,0,8937,8849,9449,1448,3383,4394,5999,4071,905,2923,3799,9743,2467,1343,0
4940,2782,9907,212,2045,0,5413,7411,3306,6552,7690,7043,9726,2905,9312,0,3789,1817,1460,5025,4928,6667,352,551,2717,371,2497,3576,6136,5253,8179,1920
2244,5130,5481,5738,9920,1334,6906,6829,2444,3193,2134,2435,8635,9956,579,6324,5392,688,61,2731,9165,0,1735,9639,9046,8926,9980,176,3264,0,513,2791
9261,4625,9247,6295,0,5003,1548,1297,2483,5270,0,3884,0,2130,0,1724,1723,5897,7745,1951,9772,6229,7362,5650,8110,0,8644,8460,8713,2297,382,3032
0,1721,5622,503,9346,1907,5269,5535,5547,7617,7738,8656,3158,7579,6034,3277,1843,5623,8674,0,5755,3792,3360,0,9678,6935,2198,2840,8985,5822,5299,0
0,6221,6015,6003,7830,851,9540,8700,7985,0,6602,2583,2147,3899,7344,2851,5095,3881,9471,748,8075,0,2611,3764,0,7845,6474,4407,1645,4219,0,2774
9597,4730,9308,8367,3794,2909,0,5589,8847,0,2584,6883,3275,3959,8313,6270,3692,9595,7029,6044,6069,0,67,4563,868,3591,9385,3236,7147,6531,156,0
1422,2801,6063,7660,8315,721,8721,3882,2421,3460,6662,0,3945,4502,5798,7811,2624,9004,93,4583,4840,4755,1433,5403,4979,4902,1340,7445,9008,7870,859,7308
4648,0,494,168,0,4313,621,4747,1052,893,5638,5029,7148,4784,1896,8600,6070,4766,69,4121,1095,2719,2325,1453,9581,1511,4973,0,1147,9304,3469,7763
7622,5425,6577,9017,1874,2586,830,6454,7611,1282,0,696,4952,0,7259,0,8485,3275,8456,9821,6578,8523,7068,2771,6517,9745,2661,1575,9731,8812,2635,5372
2839,2977,3529,6738,2262,339,5190,7377,0,4900,3485,2423,6571,0,5704,9172,9892,3460,9325,0,2293,741,3788,8330,2955,1985,6599,1566,1300,2197,3675,7723
1784,2790,8328,2828,8016,7410,4998,9650,5648,5323,8351,4002,1935,1765,0,584,2439,5096,6860,5277,0,2512,6912,0,2386,0,3631,6649,2818,3226,4090,9230
7389,1667,8717,8283,9915,9261,2403,7352,168,175,5948,4059,1361,346,6219,7160,1806,4727,9479,7398,0,6001,485,6432,2275,3274,1292,3336,284,9848,6809,317
7614,37,1163,37,7931,6290,2454,5283,6905,5260,9678,5420,3338,0,2368,2751,1062,892,2802,7775,5290,2018,4808,8690,4984,7010,1211,6319,6880,724,2803,7632
6289,9597,199,2183,0,7497,3646,3595,3137,1468,1662,1873,2364,5380,6600,1623,3,2239,5412,31,5023,9891,2011,3283,3505,8371,1727,4529,9951,1686,2817,7773
5724,5834,3512,4973,0,9876,2638,8409,5256,711,8744,4636,0,6223,8879,5126,5293,5239,1625,4054,7479,3986,0,6296,835,2923,7633,750,8547,8181,7382,0
3241,2936,7858,5994,0,2246,2897,6006,7459,5395,3336,7458,0,8452,5293,5621,2859,6159,7572,8359,2379,8927,0,617,9459,879,709,6782,2590,7947,9249,2312
4024,4385,7119,0,2439,1839,0,5155,6122,873,4107,4578,1988,0,0,9472,8075,6918,0,2173,2141,5512,228,1039,7115,998,2219,2252,3217,9196,6857,9891
3912,0,5564,1515,5194,9554,8465,3196,5888,8021,8897,2149,6977,829,9187,2389,3489,8247,6622,9500,7866,4071,3670,2161,1933,3169,3781,0,572,1853,7747,4374
6958,4446,6950,2604,3714,7145,3551,7865,9781,936,7037,8751,9799,619,4914,6540,6673,0,3610,5214,6809,0,4174,5458,9476,6886,4439,3700,4557,3233,8710,722
7335,0,9824,8191,1513,4858,9418,8140,7383,981,4769,5291,224,8886,3042,7131,6213,5446,4276,4941,2413,289,7275,3573,0,3077,6944,254,6066,0,0,1322
5344,6099,7092,3156,8614,2841,5927,3206,627,9936,9664,5163,4766,3666,9130,8556,4007,6547,1948,8522,9813,823,6254,0,0,694,868,181,648,3810,7924,4389
