9623,1330,7501,5723,6273,3167,4261,3902,9135,9242,8155,4645,8674,4662,5725,870,5591,6603,4336,6451,1082,40,675,0,901,1731,6643,722,5829,0,2541,3444
0,7142,2047,5363,5095,750,6854,6160,8445,9442,6110,1104,0,4987,1876,9741,7803,9456,0,6179,8543,6317,2962,7632,8293,0,5541,0,6971,0,3552,2089
3546,7424,966,3255,8765,2279,3469,8047,5896,9833,8712,6742,5326,7885,237,0,7360,5839,4361,3589,6782,7420,7663,1656,9430,5610,6534,6048,3956,2845,873,3998
5420,8887,4144,3799,298,5537,3368,7607,9034,5207,6443,2408,0,0,2663,0,0,9283,7811,6387,4151,5832,4577,1515,6585,2833,4422,8156,9545,8309,226,8324
5491,7243,9669,2159,8754,830,98,5369,7384,2462,1634,6734,2607,6360,4822,9379,2500,6470,9567,86,9830,8761,4723,9449,6012,9913,3692,4070,1029,9946,1328,8222
9178,0,4325,1612,7505,8576,7507,9963,5947,6736,5999,6444,81,9836,2247,1086,6034,0,8782,8398,3533,5683,1099,6812,5580,1994,6536,2074,4635,9324,4658,7786
959,7621,4326,887,4842,8524,7699,0,936,2976,8185,6761,1632,1390,9130,5194,7063,0,6083,6552,7026,5998,6846,1020,9983,5183,4676,0,9078,0,1444,3198
2581,2205,8581,6808,0,2086,2760,1777,0,1522,8863,8664,8704,9957,5813,2413,4086,3759,6455,0,3315,3155,0,927,3620,6122,4272,5485,4544,5795,7494,6622
1589,1746,6630,7358,1700,0,7928,5701,3789,4160,5601,8483,3695,6134,7934,1776,2219,6317,9222,515,1911,5314,0,148,1372,8616,199,4712,7082,5252,5900,4237
6432,7402,1738,0,3022,4327,7366,196,6741,0,1314,692,3156,7307,3794,9314,7004,1286,3756,241,5090,1435,7156,1181,6907,1616,8812,689,5921,1011,547,5300
3577,9853,6947,8199,0,0,0,3986,897,2148,7000,2093,9418,261,0,824,9100,3356,1819,4399,5745,6077,8693,207,8942,8554,8826,0,5297,2028,3608,2573
2439,0,41,6824,0,2471,885,3318,9743,0,0,1123,5910,8887,2971,9518,7640,9592,1700,8011,1840,3840,1400,3922,8468,6069,0,2380,539,0,2759,5960
3149,1434,1174,8984,7263,3217,3733,9971,8741,3934,7661,5554,0,187,4697,428,6322,6118,5027,5692,7115,1580,6046,8220,6149,7065,2941,1923,3284,3640,8061,9670
9142,2122,7620,9641,907,1769,1296,7809,3734,4555,9447,1270,4142,3888,0,176,4710,6119,626,6521,9277,9987,1885,2380,3999,597,4392,781,6378,0,6011,1341
3698,8969,6627,2221,2951,3580,3598,1077,7942,8153,4074,2389,7058,5514,6817,4050,2452,2131,6011,4061,9120,8950,5562,8348,0,4520,6705,4015,3717,8633,4173,4979
6807,5884,403,1283,8205,4903,5101,0,220,7944,8804,3410,6334,0,7802,1277,6088,0,3419,6110,1488,1457,5140,3825,7642,4248,0,1236,1851,0,3740,6449
7867,5708,8137,6459,0,2795,8701,550,2158,318,9608,8799,1024,8947,725,4679,7239,0,5511,3335,4209,9696,0,7436,2207,5440,0,7369,7786,2369,0,3841
7546,5900,5661,1870,2189,8870,5154,2060,9632,6039,6597,3410,1096,2018,8025,2853,5787,7700,2381,6303,1322,3870,6341,8920,8573,694,2868,7866,2415,1893,9521,2734
9065,8639,7629,8878,7453,8559,1455,0,6943,6921,290,0,5766,8612,7467,8598,9238,1711,2348,3176,4343,449,8738,7136,1518,0,5738,44,2748,4123,6373,2501
9690,8280,0,0,7030,4319,5123,7029,7686,6830,6331,9252,9592,7454,4048,7209,9534,3241,8214,7177,2168,9800,4464,6564,9105,4658,7140,837,2623,8370,4433,0
1520,4924,5291,7478,0,3649,208,2700,2616,3027,7337,1646,1794,5183,4355,6796,3432,5917,2847,9038,6459,8400,4681,5871,2018,5048,7971,9531,2565,3715,7534,9486
935,4601,391,1649,3187,868,4860,1050,3756,5493,5717,9801,2429,8184,839,8973,0,355,6071,9267,0,7961,0,8902,2209,7155,9455,2135,9535,2828,2908,406
2195,8457,6477,602,9941,1897,4844,6715,1197,0,4949,0,8426,8240,3414,0,9001,8219,4559,1469,6061,632,1423,0,8753,1283,486,7303,8460,0,8077,4768
5340,4597,2281,8761,2562,9079,2012,1718,8797,4797,5316,1498,6002,3666,5945,914,9247,9335,6651,6906,0,5661,9384,534,0,3701,0,0,0,5074,7398,9736
419,9831,5952,896,5598,300,6004,2080,4686,0,4056,2581,1012,4922,6349,2380,5771,3928,3089,0,1789,287,9108,9207,6911,7338,4910,0,1247,2239,4761,1331
0,0,1578,0,2385,5522,1176,4095,0,8303,5952,297,1842,0,0,697,4338,8838,6578,7527,7428,8996,5780,5835,4152,2921,5836,9757,7734,1539,4386,0
6048,2395,5066,7344,9577,8596,7569,8532,493,5948,6663,7008,4192,352,6919,8220,1704,1359,1378,2964,9762,4229,4323,0,340,4964,1942,552,0,1413,6393,2682
8320,2347,5069,7287,7580,3276,8311,7101,1914,9859,2544,7563,2543,9696,7412,8828,1128,0,3152,1178,0,0,2676,1504,264,7690,5665,7266,6653,5718,3629,9442
290,8167,6096,3456,8771,5678,6568,0,4673,4865,923,3885,6225,2822,5633,4718,6953,6278,0,8891,2945,7794,8036,9006,1692,0,9882,4145,6874,7500,4979,6056
7870,7904,5242,6509,0,6876,6748,4303,7734,2918,2718,4530,444,6073,4905,5209,7655,3496,7392,663,0,4756,688,3923,1353,9283,5576,6130,6706,9939,0,7390
1515,8927,4433,1688,6967,0,3774,485,1004,0,958,2968,9781,7885,3688,5396,5000,0,9470,1591,4922,8752,1088,7635,0,9731,3088,9012,8576,4540,5241,8479
1077,6767,1309,3250,0,6324,5041,7911,1371,3519,0,209,349,4979,271,0,9667,5600,0,2239,8173,2631,9792,4592,0,3007,7682,0,3170,5735,972,808
