1921,6859,5900,36,0,7629,8627,8198
7252,8502,0,6212,7618,926,0,7105
1174,7576,3157,842,149,0,4313,0
7638,3036,2714,838,2452,1248,286,247
9003,806,3672,3033,1625,5878,2858,6269
7979,9960,9263,7155,9163,7816,6563,7866
712,6621,5095,0,2712,9415,263,7224
4641,1874,0,1695,6102,6964,4850,7973
