8583,4284,2345,3227,5156,8395,8160,0
6085,0,9600,7983,4375,4455,181,728
2118,5349,9311,2891,2332,9151,0,9076
6055,3309,5517,792,6545,3544,2743,5307
5162,5443,2485,7344,709,3785,9378,4300
5645,0,4384,554,0,9577,0,703
3463,3046,7600,7681,9415,1414,1798,1937
5850,6475,3121,8016,1708,4299,0,8215
